111111111111
1PEC00000001
111111111111