111110000000
1PC0000100E1
111111111111