111111111111
10000P111111
10C0000E1111
111111111111
111111111111