
1000000001
100C0P0001
1000000001
1E00000001
1111111111

