
1111111111
100C1P0001
1111100001
1E00000001
1111111111

